10,7

##########
#        #
### ### ##
  # # #  #
# # # # ##
#     #   
##########
