31,20

###############################
# #       #   #   #           #
#   ##### # #   #   ######### #
# #     # # ###### ##       # #
# # ### # #     #  #  ### # # #
### # # # ##### #### ## # # # #
#     # #     # # #     # # # #
####### ##### # #   ##### # # #
        #   # # # # #   # # # #
######### # # # # # # # # # # #
#     # # # # # # # # # # ### #
# # # # # # # # # # # # #  #  #
# # #   # #   #   # # # ## # ##
# # ##### # ######### #  # #  #
# #       # #         # ## ##  
# ######### # ######### #   # #
#      # #    #       ##### # #
###### # ###### ##### #   # # #
#                   #   #   # #
###############################